af	man
ar	رجل
be	чалавек
bg	мъж
ca	home
cs	muž
cy	dyn
da	mand
de	Mann
el	άνθρωπος
eo	viro
es	hombre
et	mees
fa	مرد
fi	mies
fr	homme
ga	fear
gl	home
hi	आदमी
hr	čovjek
ht	nonm
hu	férfi
id	pria
is	maður
it	uomo
iw	גבר
ja	男性
ko	사람
lt	vyras
lv	vīrietis
mk	човек
ms	lelaki
mt	bniedem
nl	man
no	mann
pl	człowiek
pt	homem
ro	om
ru	человек
sk	muž
sl	Moški
sq	njeri
sr	човек
sv	människa
sw	mtu
th	คน
tl	tao
tr	adam
uk	людина
vi	người đàn ông
yi	מאַן
zh	男人
zh-TW	男人
