af	maan
ar	قمر
be	Месяц
bg	луна
ca	lluna
cs	měsíc
cy	lleuad
da	månen
de	Mond
el	φεγγάρι
eo	luno
es	luna
et	Kuu
fa	ماه
fi	kuu
fr	lune
ga	gealach
gl	lúa
hi	चांद
hr	mjesec
ht	lalin
hu	Hold
id	bulan
is	tunglið
it	luna
iw	ירח
ja	ムーン
ko	위성
lt	mėnulis
lv	mēness
mk	месечината
ms	bulan
mt	moon
nl	maan
no	månen
pl	księżyc
pt	lua
ro	Lună
ru	Луна
sk	mesiac
sl	luna
sq	hënë
sr	Месец
sv	moon
sw	mwezi
th	ดวงจันทร์
tl	gumala
tr	ay
uk	Місяць
vi	mặt trăng
yi	לעוואָנע
zh	月亮
zh-TW	月亮
