af	son
ar	شمس
be	сонца
bg	слънце
ca	sol
cs	slunce
cy	haul
da	sol
de	Sonne
el	ήλιος
eo	suno
es	sol
et	päike
fa	خورشید
fi	aurinko
fr	soleil
ga	ghrian
gl	sol
hi	सूरज
hr	sunce
ht	solèy
hu	nap
id	matahari
is	Sun
it	sole
iw	שמש
ja	太陽
ko	해
lt	saulė
lv	saule
mk	сонцето
ms	matahari
mt	xemx
nl	zon
no	sol
pl	słońce
pt	sol
ro	soare
ru	солнце
sk	slnko
sl	Sonce
sq	diell
sr	сунце
sv	sol
sw	jua
th	ดวงอาทิตย์
tl	araw
tr	güneş
uk	сонце
vi	mặt trời
yi	זון
zh	太阳
zh-TW	太陽
