af	vrou
ar	امرأة
be	жанчына
bg	жена
ca	dona
cs	žena
cy	menyw
da	kvinde
de	Frau
el	γυναίκα
eo	virino
es	mujer
et	naine
fa	زن
fi	nainen
fr	femme
ga	bean
gl	muller
hi	महिला
hr	žena
ht	fanm
hu	nő
id	wanita
is	kona
it	donna
iw	אישה
ja	女性
ko	여성
lt	moteris
lv	sieviete
mk	жена
ms	wanita
mt	mara
nl	vrouw
no	kvinne
pl	kobieta
pt	mulher
ro	femeie
ru	женщина
sk	žena
sl	ženska
sq	grua
sr	жена
sv	kvinna
sw	mwanamke
th	หญิง
tl	babae
tr	kadın
uk	жінка
vi	người phụ nữ
yi	פרוי
zh	女人
zh-TW	女人
